*kvilte 
*paff		
benkeskap
brekke		(ŒŞ ŒÒŒŞŒÔŒÕ) ŒÑŒãŒàŒÛŒØŒâŒì, ŒÒŒŞŒÛŒİŒŞŒÒŒĞŒâŒìŒáŒï
dørstein	ŒßŒŞŒàŒŞŒÓ
ei bikkje	ŒáŒŞŒÑŒĞŒçŒŞŒİŒÚŒĞ
ekorn		ŒÑŒÕŒÛŒÚŒĞ
ekornunge	ŒÑŒÕŒÛŒìŒçŒŞŒİŒŞŒÚ
et bjeff	ŒÛŒĞŒÙ
fluesnapper	ŒÜŒãŒåŒŞŒÛŒŞŒÒŒÚŒĞ
fluesopp	ŒÜŒãŒåŒŞŒÜŒŞŒà
fløtemugga	"ŒßŒÛŒĞŒÒŒãŒçŒØŒÙ ŒÚŒãŒÒŒèŒØŒİ"
fuglereir	ŒßŒâŒØŒçŒìŒÕ ŒÓŒİŒÕŒ×ŒÔŒŞ
fugleunge	ŒßŒâŒÕŒİŒÕŒæ
føyk		ŒÒŒìŒîŒÓŒĞ
gneldre		ŒâŒïŒÒŒÚŒĞŒâŒì
granstamme	ŒÕŒÛŒŞŒÒŒëŒÙ ŒáŒâŒÒŒŞŒÛ
grut		ŒÓŒãŒéŒĞ
haken		ŒßŒŞŒÔŒÑŒŞŒàŒŞŒÔŒŞŒÚ
heia		ŒßŒãŒáŒâŒŞŒèŒì, ŒáŒŞŒßŒÚŒØ
hermelin	ŒÓŒŞŒàŒİŒŞŒáŒâŒĞŒÙ
jakt		ŒŞŒåŒŞŒâŒĞ
kjeft		ŒßŒĞŒáŒâŒì
klatre opp	Œ×ŒĞŒÛŒÕŒ×ŒĞŒâŒì
labb(en)	ŒÛŒĞŒßŒÚŒĞ
lemen		ŒÛŒÕŒÜŒÜŒØŒİŒÓ
moro		ŒÒŒÕŒáŒÕŒÛŒìŒÕ
pjuske		ŒâŒàŒÕŒßŒĞŒâŒì
pynte seg	ŒİŒĞŒàŒïŒÖŒĞŒâŒìŒáŒï
pysle		ŒÒŒŞŒ×ŒØŒâŒìŒáŒï
rekke 		ŒàŒïŒÔ, ŒçŒÕŒàŒÕŒÔŒĞ
rovdyr		ŒåŒØŒéŒİŒØŒÚ
sikk-sakk	Œ×ŒØŒÓŒ×ŒĞŒÓ
siv		ŒÚŒĞŒÜŒëŒè
skaut(et)	ŒÚŒŞŒáŒëŒİŒÚŒĞ
skikk		ŒŞŒÑŒëŒçŒĞŒÙ
smågnager	
snut
stamme		
stem(men)	Œ×ŒĞŒáŒÛŒŞŒİŒÚŒĞ
stans		ŒŞŒáŒâŒĞŒİŒŞŒÒŒÚŒĞ
stanse		ŒŞŒáŒâŒĞŒİŒĞŒÒŒÛŒØŒÒŒĞŒâŒì
steinrøys	ŒÚŒĞŒÜŒÕŒİŒØŒáŒâŒĞŒï ŒŞŒáŒëŒßŒì, ŒÚŒĞŒÜŒÕŒİŒØŒáŒâŒëŒÙ ŒÚŒàŒĞŒÙ
stutte		
stå på gløtt	ŒßŒàŒØŒŞŒâŒÚŒàŒëŒâ (ŒßŒàŒŞ ŒáŒâŒĞŒÒŒÕŒİŒì)
surill 		
sving
særlig
tidsnok
titte
tufsemufs
tørt
vinduskarmen
